#,#,#,#,#,,,,,,,,,,,
#,SG,SG,SG,#,,,,,,,,,,,
#,SG,SG,SG,#,,,,,,,,,,,
#,SG,#,SG,#,,,,,,,,,,,
#,GT,SG,GT,#,,,,,,,,,,,
#,#,SG,#,#,#,#,#,#,#,#,#,#,#,#,#
#,I,SG,I,I,I,I,I,SG,I,I,I,I,SG,SG,#
#,I,I,I,I,I,I,I,I,I,I,I,I,SG,SP,#
#,I,SG,I,I,I,SG,I,I,I,SG,I,I,SG,SG,#
#,#,#,#,#,#,#,#,#,#,#,#,#,#,#,#