!#,!#,!#,!#,!#,!#,!#,!#,!#,!#,!#,!#,!#
!#,AG,AG,AG,AG,AG,!#,SP,GT,GT,AG,AG,!#
!#,AG,AG,AG,AG,AG,!#,GT,GT,GT,AG,AG,!#
!#,AG,AG,AG,AG,AG,!#,GT,GT,GT,AG,AG,!#
!#,GT,GT,!#,!#,!#,!#,!#,!#,!#,AG,AG,!#
!#,AG,AG,!#,,,,,,!#,SBH,SBH,!#
!#,AG,AG,!#,,,,,,!#,GT,GT,!#
!#,AG,AG,!#,!#,!#,!#,!#,!#,!#,AG,AG,!#
!#,AG,AG,GT,AG,AG,AG,AG,AG,AG,AG,AG,!#
!#,AG,AG,GT,AG,AG,AG,AG,AG,AG,AG,AG,!#
!#,AG,AG,GT,AG,AG,AG,AG,AG,AG,AG,AG,!#
!#,!#,!#,!#,!#,!#,!#,!#,!#,!#,!#,!#,!#