!#,!#,!#,!#,!#,!#,!#
!#,AG,AG,AG,AG,AG,!#
!#,AG,AG,AG,AG,AG,!#
!#,AG,AG,AG,AG,AG,!#
!#,AG,AG,AG,AG,AG,!#
!#,AG,AG,AG,AG,AG,!#
!#,AG,AG,AG,AG,AG,!#
!#,AG,AG,AG,AG,AG,!#
!#,!#,AG,AG,AG,!#,!#
,!#,!#,SP,!#,!#,
,,!#,!#,!#,,