#,#,#,#,#,#,#,
#,SG,I,I,I,SG,#,
#,I,I,I,I,I,#,
#,I,SBH,I,I,SG,#,
#,I,I,I,I,I,#,
#,I,I,I,I,I,#,
#,I,I,I,I,I,#,
#,SG,SG,#,#,#,#,
#,SG,SG,SBH,SG,SBH,#,
#,SG,SBH,#,SG,SG,#,
#,SG,SG,SBH,SG,SBH,#,
#,#,#,#,#,SG,#,
,,,,#,SBH,#,
,,,#,#,SG,#,#
,,,#,SG,SG,SG,#
,,,#,SG,SP,SG,#
,,,#,SG,SG,SG,#
,,,#,#,#,#,#