#,#,#,#,#
#,SG,SG,SG,#
#,I,I,I,#
#,SG,SG,SG,#
#,I,I,I,#
#,I,I,I,#
#,SG,SG,SG,#
#,I,I,I,#
#,I,I,I,#
#,I,I,I,#
#,SG,SG,SG,#
#,I,I,I,#
#,I,I,I,#
#,I,I,I,#
#,SG,I,SG,#
#,SG,SG,SG,#
#,SG,SP,SG,#
#,#,#,#,#