#,#,#,#,#,#,#,#,#,#,#,#,#,#
#,,CV,,,,CV,,,,,,,#
#,P,,,CV,,,,CV,,,,,#
#,,,,,,,,,,CV,,,#
#,#,#,#,#,#,#,#,#,#,#,#,#,#