#,#,#,#,#
#,,P,,#
#,,,,#
#,,,,#
#,,,,#
#,,,,#
#,,,,#
#,,,,#
#,,,,#
#,,,,#
#,,,,#
#,,,,#
#,,,,#
#,,,,#
#,,,,#
#,,,,#
#,,,,#
#,#,#,#,#