#,#,#,#,#,#,#,#,#,#,#,
#,,,,,,,,,,#,
#,P,BO,,#,BO,BO,BO,BO,BO,#,
#,,,,,,,,,,#,
#,#,#,#,#,#,#,#,#,,#,
,,,,,,,,#,,#,
#,#,#,#,#,#,#,#,#,,#,
#,,,,BO,,,,,,#,
#,BO,,,BO,,,#,#,#,#,#
#,,#,,BO,,,#,,,,#
#,,#,#,#,#,#,#,,,,#
#,,BO,,,,,,,,,#
#,,,BO,,,,#,#,#,#,#
#,,,,BO,,,#,,,,
#,#,#,#,#,#,#,#,,,,