#,#,#,#,#,#,#,#,#,#,#,
#,SG,SG,SBH,SG,SG,SBH,SG,SBH,SG,#,
#,SG,SG,SBH,#,SG,SG,SG,SG,SG,#,
#,SG,SG,SBH,SG,SBH,SG,SBH,SG,SBH,#,
#,#,#,#,#,#,#,#,#,SG,#,
,,,,,,,,#,SG,#,
#,#,#,#,#,#,#,#,#,SG,#,
#,SG,SG,#,SG,SG,SG,SG,SG,SG,#,
#,SG,SG,SG,SG,SG,SG,#,#,#,!#,!#
#,SG,SG,#,SG,SG,SG,#,SG,AG,AG,!#
#,SBH,#,#,#,!#,#,#,AG,SP,AG,!#
#,SG,SG,AG,SG,SBH,SBH,AG,SG,AG,SG,!#
#,SG,SG,SG,AG,SBH,SBH,#,!#,#,!#,!#
#,SG,AG,SG,SG,SBH,SBH,!#,,,,
#,#,#,#,#,!#,!#,#,,,,