#,#,#,#,#,,,,,,,,,,,
#,SG,SG,SG,#,,,,,,,,,,,
#,SG,SG,SG,#,,,,,,,,,,,
#,SG,#,SG,#,,,,,,,,,,,
#,GT,SG,GT,#,,,,,,,,,,,
#,#,SG,#,#,#,#,#,#,#,#,#,#,#,#,#
#,SG,SG,SG,SG,SG,SG,SG,SG,SG,SG,SG,SG,SG,SG,#
#,SG,SG,SG,SG,SG,SG,SG,SG,SG,SG,SG,SG,SG,SP,#
#,SG,SG,SG,SG,SG,SG,SG,SG,SG,SG,SG,SG,SG,SG,#
#,#,#,#,#,#,#,#,#,#,#,#,#,#,#,#