#,#,#,#,#,#,#,
#,P,BO,,,,#,
#,BO,#,#,#,,#,
#,,#,hs,#,,#,
#,,#,,#,,#,
#,,#,BO,#,,#,
#,,,,,,#,
#,,,#,#,#,#,
#,,BO,,BO,,#,
#,,,#,O,BO,#,
#,,BO,,BO,,#,
#,#,#,#,#,BO,#,
,,,,#,,#,
,,,#,#,,#,#
,,,#,,,,#
,,,#,,sp,,#
,,,#,,,,#
,,,#,#,#,#,#