#,#,#,#,#,#,#,#,#,#,#,
#,SG,SG,SBH,SG,SG,SBH,SG,SBH,SG,#,
#,SG,SG,SBH,#,SG,SG,SG,SG,SG,#,
#,SG,SG,SBH,SG,SBH,SG,SBH,SG,SBH,#,
#,#,#,#,#,#,#,#,#,SG,#,
,,,,,,,,#,SG,#,
#,#,#,#,#,#,#,#,#,SG,#,
#,SG,SG,SG,SG,SG,SG,SG,SG,SG,#,
#,SG,SG,SG,SG,SG,SG,#,#,#,#,#
#,SG,SG,SG,SG,SG,SG,#,SG,SG,SG,#
#,SBH,#,#,#,#,#,#,SG,SP,SG,#
#,SG,SG,SG,SG,SBH,SBH,SG,SG,SG,SG,#
#,SG,SG,SG,SG,SBH,SBH,#,#,#,#,#
#,SG,SG,SG,SG,SBH,SBH,#,,,,
#,#,#,#,#,#,#,#,,,,