#,#,#,#,#,#,#
#,SG,SG,SG,SG,SG,#
#,SG,SG,SG,SG,SG,#
#,SG,SG,SG,SG,SG,#
#,SG,SG,SG,SG,SG,#
#,SG,SG,SG,SG,SG,#
#,SG,SG,SG,SG,SG,#
#,SG,SG,SG,SG,SG,#
#,#,SG,SG,SG,#,#
,#,#,SP,#,#,
,,#,#,#,,