#,#,#,#,#,,,,,,,,,,,
#,,P,,#,,,,,,,,,,,
#,BO,,BO,#,,,,,,,,,,,
#,,#,,#,,,,,,,,,,,
#,,,,#,,,,,,,,,,,
#,#,,#,#,#,#,#,#,#,#,#,#,#,#,#
#,,,,C,,,,,C,,,,C,,#
#,,,,,C,,,C,,,,,,,#
#,,,,,,,,,,,,,,,#
#,#,#,#,#,#,#,#,#,#,#,#,#,#,#,#