#,#,#,#,#,#,#,#,#
#,,,BO,,,,,#
#,,,BO,,,,,#
#,P,,BO,,,,SP,#
#,,,BO,,,,,#
#,,,BO,,,,,#
#,#,#,#,#,#,#,#,#