#,#,#,#,#,#,#,#,#
#,SG,SG,SG,SG,SG,SG,SG,#
#,SG,SG,SG,SG,SG,SG,SG,#
#,SG,SG,SG,SG,SG,SG,SG,#
#,SG,SG,SG,SG,SG,SG,SG,#
#,#,#,#,SG,#,#,#,#
,,,#,WS,#,,,
#,#,#,#,SG,#,#,#,#
#,SG,SG,SG,SG,SG,SG,SG,#
#,SG,SG,SG,SG,SG,SG,SG,#
#,SG,SG,SG,SP,SG,SG,SG,#
#,SG,SG,SG,SG,SG,SG,SG,#
#,#,#,#,#,#,#,#,#