#,#,#,#,#,#,#,
#,P,B,,,,#,
#,B,#,#,#,,#,
#,,#,hs,#,,#,
#,,#,,#,,#,
#,,#,B,#,,#,
#,,,,,,#,
#,,,#,#,#,#,
#,,B,,B,,#,
#,,,#,O,B,#,
#,,B,,B,,#,
#,#,#,#,#,B,#,
,,,,#,,#,
,,,#,#,,#,#
,,,#,,,,#
,,,#,,sp,,#
,,,#,,,,#
,,,#,#,#,#,#