#,#,#,#,#,#,#,
#,SG,SG,SG,,SG,#,
#,SG,#,#,#,SG,#,
#,SG,#,SG,#,SG,#,
#,,#,,#,SG,#,
#,SG,#,SG,#,SG,#,
#,SG,SG,SG,SG,SG,#,
#,SG,SG,#,#,#,#,
#,SG,SG,,SG,,#,
#,SG,,#,SG,SG,#,
#,SG,SG,,SG,,#,
#,#,#,#,#,SG,#,
,,,,#,,#,
,,,#,#,SG,#,#
,,,#,SG,SG,SG,#
,,,#,SG,,SG,#
,,,#,SG,SG,SG,#
,,,#,#,#,#,#