#,#,#,#,#
#,,,,#
#,,,,#
#,,,,#
#,#,,#,#
,#,,#,
,#,,#,
,#,,#,
,#,,#,