#,#,#,#,#,#,#,
#,SG,SG,SG,SBH,SG,#,
#,SG,#,#,#,SG,#,
#,SG,#,SG,#,SG,#,
#,SBH,#,SBH,#,SG,#,
#,SG,#,SG,#,SG,#,
#,SG,SG,SG,SG,SG,#,
#,SG,SG,#,#,#,#,
#,SG,SG,SBH,SG,SBH,#,
#,SG,SBH,#,SG,SG,#,
#,SG,SG,SBH,SG,SBH,#,
#,#,#,#,#,SG,#,
,,,,#,SBH,#,
,,,#,#,SG,#,#
,,,#,SG,SG,SG,#
,,,#,SG,SP,SG,#
,,,#,SG,SG,SG,#
,,,#,#,#,#,#