#,#,#,#,#,#,#,#,#
#,,,,,,,,#
#,,,,P,,,,#
#,,,,,,,,#
#,,,,,,,,#
#,#,#,#,,#,#,#,#
,,,#,,#,,,
#,#,#,#,,#,#,#,#
#,,,,,,,,#
#,,,,,,,,#
#,,,,,,,,#
#,,,,,,,,#
#,#,#,#,#,#,#,#,#