#,#,#,#,#
#,SG,SG,SG,#
#,SG,P,SG,#
#,SG,SG,SG,#
#,#,SG,#,#
,#,SG,#,
,#,#,#,